"filename", "language", "Makefile", "HTML", "C", "C++", "Log", "comment", "blank", "total"
"/home/parsa/Desktop/nano/Makefile", "Makefile", 2046, 0, 0, 0, 0, 28, 72, 2146
"/home/parsa/Desktop/nano/config.h", "C++", 0, 0, 0, 614, 0, 769, 460, 1843
"/home/parsa/Desktop/nano/config.log", "Log", 0, 0, 0, 0, 11079, 0, 25, 11104
"/home/parsa/Desktop/nano/doc/Makefile", "Makefile", 2296, 0, 0, 0, 0, 26, 73, 2395
"/home/parsa/Desktop/nano/doc/faq.html", "HTML", 0, 262, 0, 0, 0, 0, 16, 278
"/home/parsa/Desktop/nano/doc/nano.1.html", "HTML", 0, 553, 0, 0, 0, 2, 177, 732
"/home/parsa/Desktop/nano/doc/nano.html", "HTML", 0, 2190, 0, 0, 0, 17, 78, 2285
"/home/parsa/Desktop/nano/doc/nanorc.5.html", "HTML", 0, 1122, 0, 0, 0, 2, 466, 1590
"/home/parsa/Desktop/nano/doc/rnano.1.html", "HTML", 0, 112, 0, 0, 0, 2, 54, 168
"/home/parsa/Desktop/nano/lib/Makefile", "Makefile", 4007, 0, 0, 0, 0, 296, 118, 4421
"/home/parsa/Desktop/nano/lib/_Noreturn.h", "C++", 0, 0, 0, 22, 0, 22, 2, 46
"/home/parsa/Desktop/nano/lib/alloca.c", "C", 0, 0, 104, 0, 0, 56, 43, 203
"/home/parsa/Desktop/nano/lib/alloca.h", "C++", 0, 0, 0, 35, 0, 34, 5, 74
"/home/parsa/Desktop/nano/lib/alloca.in.h", "C++", 0, 0, 0, 35, 0, 33, 5, 73
"/home/parsa/Desktop/nano/lib/arg-nonnull.h", "C++", 0, 0, 0, 7, 0, 18, 2, 27
"/home/parsa/Desktop/nano/lib/asnprintf.c", "C", 0, 0, 13, 0, 0, 16, 6, 35
"/home/parsa/Desktop/nano/lib/attribute.h", "C++", 0, 0, 0, 27, 0, 139, 53, 219
"/home/parsa/Desktop/nano/lib/btowc.c", "C", 0, 0, 17, 0, 0, 17, 6, 40
"/home/parsa/Desktop/nano/lib/c++defs.h", "C++", 0, 0, 0, 162, 0, 153, 17, 332
"/home/parsa/Desktop/nano/lib/cdefs.h", "C++", 0, 0, 0, 384, 0, 163, 68, 615
"/home/parsa/Desktop/nano/lib/closedir.c", "C", 0, 0, 36, 0, 0, 18, 18, 72
"/home/parsa/Desktop/nano/lib/ctype.h", "C++", 0, 0, 0, 233, 0, 274, 32, 539
"/home/parsa/Desktop/nano/lib/ctype.in.h", "C++", 0, 0, 0, 21, 0, 26, 11, 58
"/home/parsa/Desktop/nano/lib/dirent-private.h", "C++", 0, 0, 0, 14, 0, 25, 6, 45
"/home/parsa/Desktop/nano/lib/dirent.h", "C++", 0, 0, 0, 421, 0, 311, 46, 778
"/home/parsa/Desktop/nano/lib/dirent.in.h", "C++", 0, 0, 0, 202, 0, 45, 24, 271
"/home/parsa/Desktop/nano/lib/dirfd.c", "C", 0, 0, 63, 0, 0, 19, 17, 99
"/home/parsa/Desktop/nano/lib/dynarray.h", "C++", 0, 0, 0, 84, 0, 171, 30, 285
"/home/parsa/Desktop/nano/lib/errno.in.h", "C++", 0, 0, 0, 193, 0, 42, 45, 280
"/home/parsa/Desktop/nano/lib/fcntl.h", "C++", 0, 0, 0, 515, 0, 347, 87, 949
"/home/parsa/Desktop/nano/lib/fcntl.in.h", "C++", 0, 0, 0, 296, 0, 81, 65, 442
"/home/parsa/Desktop/nano/lib/filename.h", "C++", 0, 0, 0, 49, 0, 53, 11, 113
"/home/parsa/Desktop/nano/lib/flexmember.h", "C++", 0, 0, 0, 9, 0, 46, 6, 61
"/home/parsa/Desktop/nano/lib/float+.h", "C++", 0, 0, 0, 108, 0, 30, 10, 148
"/home/parsa/Desktop/nano/lib/float.c", "C", 0, 0, 11, 0, 0, 19, 4, 34
"/home/parsa/Desktop/nano/lib/float.in.h", "C++", 0, 0, 0, 102, 0, 81, 12, 195
"/home/parsa/Desktop/nano/lib/fnmatch.c", "C", 0, 0, 269, 0, 0, 57, 36, 362
"/home/parsa/Desktop/nano/lib/fnmatch.in.h", "C++", 0, 0, 0, 60, 0, 32, 19, 111
"/home/parsa/Desktop/nano/lib/fnmatch_loop.c", "C", 0, 0, 936, 0, 0, 157, 119, 1212
"/home/parsa/Desktop/nano/lib/fpucw.h", "C++", 0, 0, 0, 35, 0, 58, 16, 109
"/home/parsa/Desktop/nano/lib/free.c", "C", 0, 0, 22, 0, 0, 24, 8, 54
"/home/parsa/Desktop/nano/lib/frexp.c", "C", 0, 0, 112, 0, 0, 36, 21, 169
"/home/parsa/Desktop/nano/lib/frexpl.c", "C", 0, 0, 12, 0, 0, 16, 8, 36
"/home/parsa/Desktop/nano/lib/fstat.c", "C", 0, 0, 53, 0, 0, 29, 13, 95
"/home/parsa/Desktop/nano/lib/futimens.c", "C", 0, 0, 8, 0, 0, 24, 6, 38
"/home/parsa/Desktop/nano/lib/getdelim.c", "C", 0, 0, 97, 0, 0, 27, 24, 148
"/home/parsa/Desktop/nano/lib/getline.c", "C", 0, 0, 7, 0, 0, 16, 5, 28
"/home/parsa/Desktop/nano/lib/getlogin_r.c", "C", 0, 0, 65, 0, 0, 34, 12, 111
"/home/parsa/Desktop/nano/lib/getopt-cdefs.in.h", "C++", 0, 0, 0, 35, 0, 24, 8, 67
"/home/parsa/Desktop/nano/lib/getopt-core.h", "C++", 0, 0, 0, 11, 0, 70, 16, 97
"/home/parsa/Desktop/nano/lib/getopt-ext.h", "C++", 0, 0, 0, 23, 0, 44, 11, 78
"/home/parsa/Desktop/nano/lib/getopt-pfx-core.h", "C++", 0, 0, 0, 25, 0, 34, 8, 67
"/home/parsa/Desktop/nano/lib/getopt-pfx-ext.h", "C++", 0, 0, 0, 27, 0, 36, 8, 71
"/home/parsa/Desktop/nano/lib/getopt.c", "C", 0, 0, 482, 0, 0, 229, 101, 812
"/home/parsa/Desktop/nano/lib/getopt.in.h", "C++", 0, 0, 0, 24, 0, 29, 9, 62
"/home/parsa/Desktop/nano/lib/getopt1.c", "C", 0, 0, 113, 0, 0, 22, 25, 160
"/home/parsa/Desktop/nano/lib/getopt_int.h", "C++", 0, 0, 0, 39, 0, 59, 21, 119
"/home/parsa/Desktop/nano/lib/gettext.h", "C++", 0, 0, 0, 218, 0, 58, 26, 302
"/home/parsa/Desktop/nano/lib/gettime.c", "C", 0, 0, 22, 0, 0, 19, 9, 50
"/home/parsa/Desktop/nano/lib/gettimeofday.c", "C", 0, 0, 80, 0, 0, 44, 30, 154
"/home/parsa/Desktop/nano/lib/glob-libc.gl.h", "C++", 0, 0, 0, 117, 0, 41, 21, 179
"/home/parsa/Desktop/nano/lib/glob-libc.h", "C++", 0, 0, 0, 113, 0, 40, 21, 174
"/home/parsa/Desktop/nano/lib/glob.c", "C", 0, 0, 1186, 0, 0, 181, 148, 1515
"/home/parsa/Desktop/nano/lib/glob.in.h", "C++", 0, 0, 0, 117, 0, 33, 28, 178
"/home/parsa/Desktop/nano/lib/glob_internal.h", "C++", 0, 0, 0, 39, 0, 17, 10, 66
"/home/parsa/Desktop/nano/lib/glob_pattern_p.c", "C", 0, 0, 11, 0, 0, 19, 4, 34
"/home/parsa/Desktop/nano/lib/globfree.c", "C", 0, 0, 20, 0, 0, 18, 4, 42
"/home/parsa/Desktop/nano/lib/glthread/lock.c", "C", 0, 0, 590, 0, 0, 71, 89, 750
"/home/parsa/Desktop/nano/lib/glthread/lock.h", "C++", 0, 0, 0, 549, 0, 134, 107, 790
"/home/parsa/Desktop/nano/lib/glthread/threadlib.c", "C", 0, 0, 59, 0, 0, 26, 24, 109
"/home/parsa/Desktop/nano/lib/hard-locale.c", "C", 0, 0, 12, 0, 0, 17, 7, 36
"/home/parsa/Desktop/nano/lib/hard-locale.h", "C++", 0, 0, 0, 5, 0, 19, 5, 29
"/home/parsa/Desktop/nano/lib/idx.h", "C++", 0, 0, 0, 7, 0, 98, 10, 115
"/home/parsa/Desktop/nano/lib/intprops.h", "C++", 0, 0, 0, 333, 0, 258, 50, 641
"/home/parsa/Desktop/nano/lib/inttypes.h", "C++", 0, 0, 0, 1150, 0, 304, 56, 1510
"/home/parsa/Desktop/nano/lib/inttypes.in.h", "C++", 0, 0, 0, 931, 0, 38, 34, 1003
"/home/parsa/Desktop/nano/lib/isblank.c", "C", 0, 0, 7, 0, 0, 23, 4, 34
"/home/parsa/Desktop/nano/lib/isnan.c", "C", 0, 0, 123, 0, 0, 52, 15, 190
"/home/parsa/Desktop/nano/lib/isnand-nolibm.h", "C++", 0, 0, 0, 14, 0, 18, 2, 34
"/home/parsa/Desktop/nano/lib/isnand.c", "C", 0, 0, 1, 0, 0, 16, 3, 20
"/home/parsa/Desktop/nano/lib/isnanf-nolibm.h", "C++", 0, 0, 0, 18, 0, 22, 2, 42
"/home/parsa/Desktop/nano/lib/isnanf.c", "C", 0, 0, 2, 0, 0, 16, 3, 21
"/home/parsa/Desktop/nano/lib/isnanl-nolibm.h", "C++", 0, 0, 0, 14, 0, 19, 2, 35
"/home/parsa/Desktop/nano/lib/isnanl.c", "C", 0, 0, 2, 0, 0, 16, 3, 21
"/home/parsa/Desktop/nano/lib/iswblank.c", "C", 0, 0, 7, 0, 0, 16, 4, 27
"/home/parsa/Desktop/nano/lib/itold.c", "C", 0, 0, 7, 0, 0, 18, 4, 29
"/home/parsa/Desktop/nano/lib/langinfo.h", "C++", 0, 0, 0, 374, 0, 282, 48, 704
"/home/parsa/Desktop/nano/lib/langinfo.in.h", "C++", 0, 0, 0, 162, 0, 34, 27, 223
"/home/parsa/Desktop/nano/lib/lc-charset-dispatch.c", "C", 0, 0, 46, 0, 0, 22, 15, 83
"/home/parsa/Desktop/nano/lib/lc-charset-dispatch.h", "C++", 0, 0, 0, 15, 0, 19, 7, 41
"/home/parsa/Desktop/nano/lib/libc-config.h", "C++", 0, 0, 0, 117, 0, 55, 17, 189
"/home/parsa/Desktop/nano/lib/limits.h", "C++", 0, 0, 0, 73, 0, 33, 17, 123
"/home/parsa/Desktop/nano/lib/limits.in.h", "C++", 0, 0, 0, 74, 0, 32, 16, 122
"/home/parsa/Desktop/nano/lib/localcharset.c", "C", 0, 0, 840, 0, 0, 260, 60, 1160
"/home/parsa/Desktop/nano/lib/localcharset.h", "C++", 0, 0, 0, 10, 0, 117, 11, 138
"/home/parsa/Desktop/nano/lib/locale.h", "C++", 0, 0, 0, 415, 0, 344, 54, 813
"/home/parsa/Desktop/nano/lib/locale.in.h", "C++", 0, 0, 0, 196, 0, 78, 32, 306
"/home/parsa/Desktop/nano/lib/localeconv.c", "C", 0, 0, 71, 0, 0, 19, 14, 104
"/home/parsa/Desktop/nano/lib/lstat.c", "C", 0, 0, 42, 0, 0, 50, 13, 105
"/home/parsa/Desktop/nano/lib/malloc.c", "C", 0, 0, 22, 0, 0, 18, 12, 52
"/home/parsa/Desktop/nano/lib/malloc/dynarray-skeleton.c", "C", 0, 0, 319, 0, 0, 167, 43, 529
"/home/parsa/Desktop/nano/lib/malloc/dynarray-skeleton.gl.h", "C++", 0, 0, 0, 319, 0, 168, 43, 530
"/home/parsa/Desktop/nano/lib/malloc/dynarray.gl.h", "C++", 0, 0, 0, 39, 0, 120, 16, 175
"/home/parsa/Desktop/nano/lib/malloc/dynarray.h", "C++", 0, 0, 0, 44, 0, 119, 16, 179
"/home/parsa/Desktop/nano/lib/malloc/dynarray_at_failure.c", "C", 0, 0, 19, 0, 0, 17, 4, 40
"/home/parsa/Desktop/nano/lib/malloc/dynarray_emplace_enlarge.c", "C", 0, 0, 50, 0, 0, 23, 5, 78
"/home/parsa/Desktop/nano/lib/malloc/dynarray_finalize.c", "C", 0, 0, 37, 0, 0, 23, 7, 67
"/home/parsa/Desktop/nano/lib/malloc/dynarray_resize.c", "C", 0, 0, 40, 0, 0, 23, 6, 69
"/home/parsa/Desktop/nano/lib/malloc/dynarray_resize_clear.c", "C", 0, 0, 18, 0, 0, 18, 4, 40
"/home/parsa/Desktop/nano/lib/malloc/scratch_buffer.gl.h", "C++", 0, 0, 0, 52, 0, 81, 16, 149
"/home/parsa/Desktop/nano/lib/malloc/scratch_buffer.h", "C++", 0, 0, 0, 56, 0, 80, 16, 152
"/home/parsa/Desktop/nano/lib/malloc/scratch_buffer_dupfree.c", "C", 0, 0, 21, 0, 0, 17, 4, 42
"/home/parsa/Desktop/nano/lib/malloc/scratch_buffer_grow.c", "C", 0, 0, 28, 0, 0, 21, 8, 57
"/home/parsa/Desktop/nano/lib/malloc/scratch_buffer_grow_preserve.c", "C", 0, 0, 39, 0, 0, 22, 7, 68
"/home/parsa/Desktop/nano/lib/malloc/scratch_buffer_set_array_size.c", "C", 0, 0, 33, 0, 0, 23, 9, 65
"/home/parsa/Desktop/nano/lib/malloca.c", "C", 0, 0, 51, 0, 0, 47, 10, 108
"/home/parsa/Desktop/nano/lib/malloca.h", "C++", 0, 0, 0, 61, 0, 46, 18, 125
"/home/parsa/Desktop/nano/lib/math.c", "C", 0, 0, 4, 0, 0, 16, 3, 23
"/home/parsa/Desktop/nano/lib/math.h", "C++", 0, 0, 0, 2595, 0, 406, 194, 3195
"/home/parsa/Desktop/nano/lib/math.in.h", "C++", 0, 0, 0, 2376, 0, 140, 172, 2688
"/home/parsa/Desktop/nano/lib/mbrtowc-impl-utf8.h", "C++", 0, 0, 0, 107, 0, 19, 13, 139
"/home/parsa/Desktop/nano/lib/mbrtowc-impl.h", "C++", 0, 0, 0, 182, 0, 46, 35, 263
"/home/parsa/Desktop/nano/lib/mbrtowc.c", "C", 0, 0, 104, 0, 0, 24, 31, 159
"/home/parsa/Desktop/nano/lib/mbsinit.c", "C", 0, 0, 22, 0, 0, 37, 12, 71
"/home/parsa/Desktop/nano/lib/mbsrtowcs-impl.h", "C++", 0, 0, 0, 77, 0, 30, 16, 123
"/home/parsa/Desktop/nano/lib/mbsrtowcs-state.c", "C", 0, 0, 8, 0, 0, 26, 4, 38
"/home/parsa/Desktop/nano/lib/mbsrtowcs.c", "C", 0, 0, 12, 0, 0, 17, 8, 37
"/home/parsa/Desktop/nano/lib/mbtowc-impl.h", "C++", 0, 0, 0, 22, 0, 19, 4, 45
"/home/parsa/Desktop/nano/lib/mbtowc-lock.c", "C", 0, 0, 80, 0, 0, 41, 30, 151
"/home/parsa/Desktop/nano/lib/mbtowc-lock.h", "C++", 0, 0, 0, 72, 0, 25, 29, 126
"/home/parsa/Desktop/nano/lib/mbtowc.c", "C", 0, 0, 6, 0, 0, 16, 5, 27
"/home/parsa/Desktop/nano/lib/memchr.c", "C", 0, 0, 76, 0, 0, 73, 24, 173
"/home/parsa/Desktop/nano/lib/mempcpy.c", "C", 0, 0, 9, 0, 0, 19, 6, 34
"/home/parsa/Desktop/nano/lib/msvc-inval.c", "C", 0, 0, 83, 0, 0, 26, 21, 130
"/home/parsa/Desktop/nano/lib/msvc-inval.h", "C++", 0, 0, 0, 100, 0, 90, 33, 223
"/home/parsa/Desktop/nano/lib/msvc-nothrow.c", "C", 0, 0, 25, 0, 0, 18, 9, 52
"/home/parsa/Desktop/nano/lib/msvc-nothrow.h", "C++", 0, 0, 0, 10, 0, 24, 10, 44
"/home/parsa/Desktop/nano/lib/nl_langinfo-lock.c", "C", 0, 0, 80, 0, 0, 41, 30, 151
"/home/parsa/Desktop/nano/lib/nl_langinfo.c", "C", 0, 0, 434, 0, 0, 79, 60, 573
"/home/parsa/Desktop/nano/lib/opendir.c", "C", 0, 0, 125, 0, 0, 26, 29, 180
"/home/parsa/Desktop/nano/lib/pathmax.h", "C++", 0, 0, 0, 22, 0, 51, 11, 84
"/home/parsa/Desktop/nano/lib/printf-args.c", "C", 0, 0, 137, 0, 0, 41, 6, 184
"/home/parsa/Desktop/nano/lib/printf-args.h", "C++", 0, 0, 0, 104, 0, 31, 16, 151
"/home/parsa/Desktop/nano/lib/printf-frexp.c", "C", 0, 0, 129, 0, 0, 40, 22, 191
"/home/parsa/Desktop/nano/lib/printf-frexp.h", "C++", 0, 0, 0, 1, 0, 21, 2, 24
"/home/parsa/Desktop/nano/lib/printf-frexpl.c", "C", 0, 0, 13, 0, 0, 16, 9, 38
"/home/parsa/Desktop/nano/lib/printf-frexpl.h", "C++", 0, 0, 0, 1, 0, 21, 2, 24
"/home/parsa/Desktop/nano/lib/printf-parse.c", "C", 0, 0, 502, 0, 0, 88, 43, 633
"/home/parsa/Desktop/nano/lib/printf-parse.h", "C++", 0, 0, 0, 135, 0, 36, 23, 194
"/home/parsa/Desktop/nano/lib/raise.c", "C", 0, 0, 47, 0, 0, 21, 16, 84
"/home/parsa/Desktop/nano/lib/readdir.c", "C", 0, 0, 61, 0, 0, 29, 13, 103
"/home/parsa/Desktop/nano/lib/realloc.c", "C", 0, 0, 27, 0, 0, 23, 14, 64
"/home/parsa/Desktop/nano/lib/regcomp.c", "C", 0, 0, 3089, 0, 0, 488, 341, 3918
"/home/parsa/Desktop/nano/lib/regex.c", "C", 0, 0, 49, 0, 0, 24, 11, 84
"/home/parsa/Desktop/nano/lib/regex.h", "C++", 0, 0, 0, 273, 0, 268, 123, 664
"/home/parsa/Desktop/nano/lib/regex_internal.c", "C", 0, 0, 1410, 0, 0, 179, 158, 1747
"/home/parsa/Desktop/nano/lib/regex_internal.h", "C++", 0, 0, 0, 629, 0, 113, 105, 847
"/home/parsa/Desktop/nano/lib/regexec.c", "C", 0, 0, 3370, 0, 0, 526, 365, 4261
"/home/parsa/Desktop/nano/lib/scratch_buffer.h", "C++", 0, 0, 0, 33, 0, 78, 17, 128
"/home/parsa/Desktop/nano/lib/setlocale-lock.c", "C", 0, 0, 80, 0, 0, 41, 30, 151
"/home/parsa/Desktop/nano/lib/setlocale_null.c", "C", 0, 0, 297, 0, 0, 54, 61, 412
"/home/parsa/Desktop/nano/lib/setlocale_null.h", "C++", 0, 0, 0, 16, 0, 52, 15, 83
"/home/parsa/Desktop/nano/lib/sig-handler.c", "C", 0, 0, 3, 0, 0, 16, 3, 22
"/home/parsa/Desktop/nano/lib/sig-handler.h", "C++", 0, 0, 0, 18, 0, 26, 8, 52
"/home/parsa/Desktop/nano/lib/sigaction.c", "C", 0, 0, 106, 0, 0, 79, 20, 205
"/home/parsa/Desktop/nano/lib/signal.h", "C++", 0, 0, 0, 556, 0, 353, 86, 995
"/home/parsa/Desktop/nano/lib/signal.in.h", "C++", 0, 0, 0, 337, 0, 87, 64, 488
"/home/parsa/Desktop/nano/lib/signbitd.c", "C", 0, 0, 34, 0, 0, 25, 6, 65
"/home/parsa/Desktop/nano/lib/signbitf.c", "C", 0, 0, 34, 0, 0, 25, 6, 65
"/home/parsa/Desktop/nano/lib/signbitl.c", "C", 0, 0, 34, 0, 0, 25, 6, 65
"/home/parsa/Desktop/nano/lib/sigprocmask.c", "C", 0, 0, 251, 0, 0, 57, 42, 350
"/home/parsa/Desktop/nano/lib/size_max.h", "C++", 0, 0, 0, 7, 0, 20, 4, 31
"/home/parsa/Desktop/nano/lib/snprintf.c", "C", 0, 0, 38, 0, 0, 22, 12, 72
"/home/parsa/Desktop/nano/lib/stat-time.c", "C", 0, 0, 3, 0, 0, 16, 3, 22
"/home/parsa/Desktop/nano/lib/stat-time.h", "C++", 0, 0, 0, 179, 0, 51, 23, 253
"/home/parsa/Desktop/nano/lib/stat-w32.c", "C", 0, 0, 285, 0, 0, 141, 36, 462
"/home/parsa/Desktop/nano/lib/stat-w32.h", "C++", 0, 0, 0, 12, 0, 20, 6, 38
"/home/parsa/Desktop/nano/lib/stat.c", "C", 0, 0, 290, 0, 0, 100, 51, 441
"/home/parsa/Desktop/nano/lib/stdarg.in.h", "C++", 0, 0, 0, 13, 0, 16, 7, 36
"/home/parsa/Desktop/nano/lib/stdbool.in.h", "C++", 0, 0, 0, 35, 0, 87, 11, 133
"/home/parsa/Desktop/nano/lib/stddef.in.h", "C++", 0, 0, 0, 78, 0, 54, 16, 148
"/home/parsa/Desktop/nano/lib/stdint.in.h", "C++", 0, 0, 0, 497, 0, 146, 98, 741
"/home/parsa/Desktop/nano/lib/stdio.h", "C++", 0, 0, 0, 1549, 0, 486, 114, 2149
"/home/parsa/Desktop/nano/lib/stdio.in.h", "C++", 0, 0, 0, 1330, 0, 220, 92, 1642
"/home/parsa/Desktop/nano/lib/stdlib.h", "C++", 0, 0, 0, 1390, 0, 498, 106, 1994
"/home/parsa/Desktop/nano/lib/stdlib.in.h", "C++", 0, 0, 0, 1149, 0, 210, 83, 1442
"/home/parsa/Desktop/nano/lib/str-two-way.h", "C++", 0, 0, 0, 249, 0, 183, 21, 453
"/home/parsa/Desktop/nano/lib/strcasecmp.c", "C", 0, 0, 28, 0, 0, 23, 12, 63
"/home/parsa/Desktop/nano/lib/strcasestr.c", "C", 0, 0, 46, 0, 0, 27, 10, 83
"/home/parsa/Desktop/nano/lib/streq.h", "C++", 0, 0, 0, 133, 0, 23, 21, 177
"/home/parsa/Desktop/nano/lib/string.h", "C++", 0, 0, 0, 1086, 0, 517, 94, 1697
"/home/parsa/Desktop/nano/lib/string.in.h", "C++", 0, 0, 0, 867, 0, 251, 72, 1190
"/home/parsa/Desktop/nano/lib/strings.h", "C++", 0, 0, 0, 285, 0, 304, 41, 630
"/home/parsa/Desktop/nano/lib/strings.in.h", "C++", 0, 0, 0, 66, 0, 38, 19, 123
"/home/parsa/Desktop/nano/lib/strncasecmp.c", "C", 0, 0, 28, 0, 0, 23, 12, 63
"/home/parsa/Desktop/nano/lib/strnlen.c", "C", 0, 0, 8, 0, 0, 18, 5, 31
"/home/parsa/Desktop/nano/lib/strnlen1.c", "C", 0, 0, 12, 0, 0, 19, 5, 36
"/home/parsa/Desktop/nano/lib/strnlen1.h", "C++", 0, 0, 0, 12, 0, 18, 11, 41
"/home/parsa/Desktop/nano/lib/sys/stat.h", "C++", 0, 0, 0, 957, 0, 362, 117, 1436
"/home/parsa/Desktop/nano/lib/sys/time.h", "C++", 0, 0, 0, 389, 0, 299, 44, 732
"/home/parsa/Desktop/nano/lib/sys/types.h", "C++", 0, 0, 0, 52, 0, 34, 22, 108
"/home/parsa/Desktop/nano/lib/sys/wait.h", "C++", 0, 0, 0, 270, 0, 290, 53, 613
"/home/parsa/Desktop/nano/lib/sys_stat.in.h", "C++", 0, 0, 0, 738, 0, 96, 95, 929
"/home/parsa/Desktop/nano/lib/sys_time.in.h", "C++", 0, 0, 0, 170, 0, 33, 22, 225
"/home/parsa/Desktop/nano/lib/sys_types.in.h", "C++", 0, 0, 0, 53, 0, 33, 21, 107
"/home/parsa/Desktop/nano/lib/sys_wait.in.h", "C++", 0, 0, 0, 58, 0, 42, 32, 132
"/home/parsa/Desktop/nano/lib/time.h", "C++", 0, 0, 0, 525, 0, 362, 62, 949
"/home/parsa/Desktop/nano/lib/time.in.h", "C++", 0, 0, 0, 306, 0, 96, 40, 442
"/home/parsa/Desktop/nano/lib/timespec.c", "C", 0, 0, 3, 0, 0, 16, 3, 22
"/home/parsa/Desktop/nano/lib/timespec.h", "C++", 0, 0, 0, 55, 0, 26, 21, 102
"/home/parsa/Desktop/nano/lib/unistd.c", "C", 0, 0, 4, 0, 0, 16, 3, 23
"/home/parsa/Desktop/nano/lib/unistd.h", "C++", 0, 0, 0, 2030, 0, 606, 175, 2811
"/home/parsa/Desktop/nano/lib/unistd.in.h", "C++", 0, 0, 0, 1811, 0, 340, 153, 2304
"/home/parsa/Desktop/nano/lib/unitypes.h", "C++", 0, 0, 0, 30, 0, 25, 8, 63
"/home/parsa/Desktop/nano/lib/unitypes.in.h", "C++", 0, 0, 0, 30, 0, 24, 8, 62
"/home/parsa/Desktop/nano/lib/uniwidth.h", "C++", 0, 0, 0, 33, 0, 26, 15, 74
"/home/parsa/Desktop/nano/lib/uniwidth.in.h", "C++", 0, 0, 0, 33, 0, 25, 15, 73
"/home/parsa/Desktop/nano/lib/uniwidth/cjk.h", "C++", 0, 0, 0, 16, 0, 19, 3, 38
"/home/parsa/Desktop/nano/lib/uniwidth/width.c", "C", 0, 0, 390, 0, 0, 73, 6, 469
"/home/parsa/Desktop/nano/lib/utime.c", "C", 0, 0, 211, 0, 0, 45, 33, 289
"/home/parsa/Desktop/nano/lib/utime.h", "C++", 0, 0, 0, 288, 0, 291, 41, 620
"/home/parsa/Desktop/nano/lib/utime.in.h", "C++", 0, 0, 0, 69, 0, 25, 19, 113
"/home/parsa/Desktop/nano/lib/utimens.c", "C", 0, 0, 435, 0, 0, 163, 50, 648
"/home/parsa/Desktop/nano/lib/utimens.h", "C++", 0, 0, 0, 23, 0, 18, 9, 50
"/home/parsa/Desktop/nano/lib/vasnprintf.c", "C", 0, 0, 4734, 0, 0, 791, 342, 5867
"/home/parsa/Desktop/nano/lib/vasnprintf.h", "C++", 0, 0, 0, 22, 0, 42, 9, 73
"/home/parsa/Desktop/nano/lib/verify.h", "C++", 0, 0, 0, 96, 0, 192, 28, 316
"/home/parsa/Desktop/nano/lib/vsnprintf.c", "C", 0, 0, 37, 0, 0, 22, 12, 71
"/home/parsa/Desktop/nano/lib/warn-on-use.h", "C++", 0, 0, 0, 51, 0, 94, 5, 150
"/home/parsa/Desktop/nano/lib/wchar.h", "C++", 0, 0, 0, 1232, 0, 406, 128, 1766
"/home/parsa/Desktop/nano/lib/wchar.in.h", "C++", 0, 0, 0, 1013, 0, 140, 106, 1259
"/home/parsa/Desktop/nano/lib/wcrtomb.c", "C", 0, 0, 48, 0, 0, 25, 8, 81
"/home/parsa/Desktop/nano/lib/wctype-h.c", "C", 0, 0, 3, 0, 0, 17, 4, 24
"/home/parsa/Desktop/nano/lib/wctype.h", "C++", 0, 0, 0, 788, 0, 328, 98, 1214
"/home/parsa/Desktop/nano/lib/wctype.in.h", "C++", 0, 0, 0, 576, 0, 80, 77, 733
"/home/parsa/Desktop/nano/lib/wcwidth.c", "C", 0, 0, 41, 0, 0, 25, 8, 74
"/home/parsa/Desktop/nano/lib/windows-initguard.h", "C++", 0, 0, 0, 12, 0, 17, 7, 36
"/home/parsa/Desktop/nano/lib/windows-mutex.c", "C", 0, 0, 60, 0, 0, 26, 10, 96
"/home/parsa/Desktop/nano/lib/windows-mutex.h", "C++", 0, 0, 0, 24, 0, 17, 11, 52
"/home/parsa/Desktop/nano/lib/windows-once.c", "C", 0, 0, 32, 0, 0, 25, 6, 63
"/home/parsa/Desktop/nano/lib/windows-once.h", "C++", 0, 0, 0, 21, 0, 17, 10, 48
"/home/parsa/Desktop/nano/lib/windows-recmutex.c", "C", 0, 0, 92, 0, 0, 26, 10, 128
"/home/parsa/Desktop/nano/lib/windows-recmutex.h", "C++", 0, 0, 0, 26, 0, 20, 12, 58
"/home/parsa/Desktop/nano/lib/windows-rwlock.c", "C", 0, 0, 278, 0, 0, 80, 20, 378
"/home/parsa/Desktop/nano/lib/windows-rwlock.h", "C++", 0, 0, 0, 37, 0, 20, 12, 69
"/home/parsa/Desktop/nano/lib/wmemchr-impl.h", "C++", 0, 0, 0, 10, 0, 16, 2, 28
"/home/parsa/Desktop/nano/lib/wmemchr.c", "C", 0, 0, 3, 0, 0, 17, 4, 24
"/home/parsa/Desktop/nano/lib/wmempcpy.c", "C", 0, 0, 7, 0, 0, 18, 4, 29
"/home/parsa/Desktop/nano/lib/xalloc-oversized.h", "C++", 0, 0, 0, 22, 0, 37, 7, 66
"/home/parsa/Desktop/nano/lib/xsize.c", "C", 0, 0, 3, 0, 0, 16, 3, 22
"/home/parsa/Desktop/nano/lib/xsize.h", "C++", 0, 0, 0, 46, 0, 47, 16, 109
"/home/parsa/Desktop/nano/m4/Makefile", "Makefile", 1723, 0, 0, 0, 0, 12, 56, 1791
"/home/parsa/Desktop/nano/po/Makefile", "Makefile", 409, 0, 0, 0, 0, 66, 65, 540
"/home/parsa/Desktop/nano/src/Makefile", "Makefile", 1931, 0, 0, 0, 0, 27, 73, 2031
"/home/parsa/Desktop/nano/src/browser.c", "C", 0, 0, 467, 0, 0, 158, 112, 737
"/home/parsa/Desktop/nano/src/chars.c", "C", 0, 0, 465, 0, 0, 71, 121, 657
"/home/parsa/Desktop/nano/src/color.c", "C", 0, 0, 243, 0, 0, 67, 65, 375
"/home/parsa/Desktop/nano/src/cut.c", "C", 0, 0, 501, 0, 0, 111, 117, 729
"/home/parsa/Desktop/nano/src/definitions.h", "C++", 0, 0, 0, 411, 0, 166, 55, 632
"/home/parsa/Desktop/nano/src/files.c", "C", 0, 0, 1812, 0, 0, 414, 445, 2671
"/home/parsa/Desktop/nano/src/global.c", "C", 0, 0, 1257, 0, 0, 179, 143, 1579
"/home/parsa/Desktop/nano/src/help.c", "C", 0, 0, 442, 0, 0, 70, 67, 579
"/home/parsa/Desktop/nano/src/history.c", "C", 0, 0, 403, 0, 0, 91, 119, 613
"/home/parsa/Desktop/nano/src/move.c", "C", 0, 0, 424, 0, 0, 111, 100, 635
"/home/parsa/Desktop/nano/src/nano.c", "C", 0, 0, 1994, 0, 0, 268, 276, 2538
"/home/parsa/Desktop/nano/src/prompt.c", "C", 0, 0, 554, 0, 0, 131, 108, 793
"/home/parsa/Desktop/nano/src/prototypes.h", "C++", 0, 0, 0, 568, 0, 37, 55, 660
"/home/parsa/Desktop/nano/src/rcfile.c", "C", 0, 0, 1355, 0, 0, 142, 213, 1710
"/home/parsa/Desktop/nano/src/revision.h", "C++", 0, 0, 0, 1, 0, 0, 1, 2
"/home/parsa/Desktop/nano/src/search.c", "C", 0, 0, 675, 0, 0, 184, 168, 1027
"/home/parsa/Desktop/nano/src/text.c", "C", 0, 0, 2218, 0, 0, 453, 502, 3173
"/home/parsa/Desktop/nano/src/utils.c", "C", 0, 0, 345, 0, 0, 89, 91, 525
"/home/parsa/Desktop/nano/src/winio.c", "C", 0, 0, 2653, 0, 0, 627, 470, 3750
"/home/parsa/Desktop/nano/syntax/Makefile", "Makefile", 1812, 0, 0, 0, 0, 12, 60, 1884
"Total", "-", 14224, 4239, 39893, 38939, 11079, 25622, 12882, 146878